Alder: ADE ADR AER ALD ALE ALR
Crab Apple: ALE APE APE APL APL APP CAB CRA CRB
Common Ash: ASH CMM CMN CMN CMO CMO COM COM CON CON COO
Silver Birch: BCH BIC BIH BIR BRC BRH SER SIE SIL SIR SIV SLE SLR SLV SVE SVR
Downy Birch: BCH BIC BIH BIR BRC BRH DNY DON DOW DOY DWN DWY
European Beech: BCH BEC BEC BEE BEH BEH EAN EEA EEN EOA EOE EON EOP EPA EPE EPN ERA ERE ERN ERO ERP EUA EUE EUN EUO EUP EUR
Box: BOX
Wild Cherry: CER CER CEY CHE CHR CHR CHY CRR CRY CRY WID WIL WLD
Bird Cherry: BID BIR BRD CER CER CEY CHE CHR CHR CHY CRR CRY CRY
Blackthorn: BAC BAH BAK BAN BAO BAR BAT BCH BCK BCN BCO BCR BCT BHN BHO BHR BKH BKN BKO BKR BKT BLA BLC BLH BLK BLN BLO BLR BLT BON BOR BRN BTH BTN BTO BTR
Wych Elm: ELM WCH WYC WYH
Smooth-leaved Elm: ELM LAD LAE LAV LEA LED LED LEE LEV LVD LVE SMH SMO SMO SMT SOH SOH SOO SOT SOT STH
Common Hawthorn: CMM CMN CMN CMO CMO COM COM CON CON COO HAH HAN HAO HAR HAT HAW HHN HHO HHR HON HOR HRN HTH HTN HTO HTR HWH HWN HWO HWR HWT
Midland Hawthorn: HAH HAN HAO HAR HAT HAW HHN HHO HHR HON HOR HRN HTH HTN HTO HTR HWH HWN HWO HWR HWT MAD MAN MDA MDD MDL MDN MIA MID MID MIL MIN MLA MLD MLN MND
Common Hazel: CMM CMN CMN CMO CMO COM COM CON CON COO HAE HAL HAZ HEL HZE HZL
European Hornbeam: EAN EEA EEN EOA EOE EON EOP EPA EPE EPN ERA ERE ERN ERO ERP EUA EUE EUN EUO EUP EUR HAM HBA HBE HBM HEA HEM HNA HNB HNE HNM HOA HOB HOE HOM HON HOR HRA HRB HRE HRM HRN
European Holly: EAN EEA EEN EOA EOE EON EOP EPA EPE EPN ERA ERE ERN ERO ERP EUA EUE EUN EUO EUP EUR HLL HLY HLY HOL HOL HOY
Common Juniper: CMM CMN CMN CMO CMO COM COM CON CON COO JER JIE JIP JIR JNE JNI JNP JNR JPE JPR JUE JUI JUN JUP JUR
Small-leaved Lime: LAD LAE LAV LEA LED LED LEE LEV LIE LIM LME LVD LVE SAL SAL SLL SMA SML SML
Large-leaved Lime: LAD LAE LAE LAG LAR LAV LEA LED LED LEE LEV LGE LIE LIM LME LRE LRG LVD LVE
Field Maple: FED FEL FID FIE FIL FLD MAE MAL MAP MLE MPE MPL
Pedunculate Oak: OAK PAE PAT PCA PCE PCL PCT PCU PDA PDC PDE PDL PDN PDT PDU PDU PEA PEC PED PEE PEL PEN PET PEU PEU PLA PLE PLT PNA PNC PNE PNL PNT PNU PTE PUA PUA PUC PUE PUE PUL PUL PUN PUT PUT PUU
Sessile Oak: OAK SEE SEI SEL SES SES SIE SIL SLE SSE SSE SSI SSI SSL SSL SSS
Scots Pine: PIE PIN PNE SCO SCS SCT SOS SOT STS
Aspen: AEN APE APN ASE ASN ASP
Black Poplar: BAC BAK BCK BLA BLC BLK PAR PLA PLR POA POL POP POR PPA PPL PPR
European Rowan: EAN EEA EEN EOA EOE EON EOP EPA EPE EPN ERA ERE ERN ERO ERP EUA EUE EUN EUO EUP EUR RAN ROA RON ROW RWA RWN
Common Whitebeam: CMM CMN CMN CMO CMO COM COM CON CON COO WAM WBA WBE WBM WEA WEA WEB WEE WEM WEM WHA WHB WHE WHE WHI WHM WHT WIA WIB WIE WIE WIM WIT WTA WTB WTE WTE WTM
Service Tree: SCE SEC SEE SEI SER SEV SIC SIE SRC SRE SRI SRV SVC SVE SVI TEE TRE TRE
Wild Service Tree: SCE SEC SEE SEI SER SEV SIC SIE SRC SRE SRI SRV SVC SVE SVI TEE TRE TRE WID WIL WLD
Strawberry Tree: SAB SAE SAR SAR SAW SAY SBE SBR SBR SBY SER SER SEY SRA SRB SRE SRR SRR SRR SRW SRY SRY SRY STA STB STE STR STR STR STW STY SWB SWE SWR SWR SWY TEE TRE TRE
Bay Willow: BAY WIL WIL WIO WIW WLL WLO WLO WLW WLW WOW
Crack Willow: CAC CAK CCK CRA CRC CRK WIL WIL WIO WIW WLL WLO WLO WLW WLW WOW
White Willow: WHE WHI WHT WIE WIL WIL WIO WIT WIW WLL WLO WLO WLW WLW WOW WTE
Almond-leaved Willow: ALD ALM ALN ALO AMD AMN AMO AND AOD AON LAD LAE LAV LEA LED LED LEE LEV LVD LVE WIL WIL WIO WIW WLL WLO WLO WLW WLW WOW
European Yew: EAN EEA EEN EOA EOE EON EOP EPA EPE EPN ERA ERE ERN ERO ERP EUA EUE EUN EUO EUP EUR YEW
Alder Buckthorn: ADE ADR AER ALD ALE ALR BCH BCK BCN BCO BCR BCT BHN BHO BHR BKH BKN BKO BKR BKT BON BOR BRN BTH BTN BTO BTR BUC BUH BUK BUN BUO BUR BUT
Purging Buckthorn: BCH BCK BCN BCO BCR BCT BHN BHO BHR BKH BKN BKO BKR BKT BON BOR BRN BTH BTN BTO BTR BUC BUH BUK BUN BUO BUR BUT PGG PGI PGN PIG PIN PNG PRG PRG PRI PRN PUG PUG PUI PUN PUR
Elder: EDE EDR EER ELD ELE ELR
Common Dogwood: CMM CMN CMN CMO CMO COM COM CON CON COO DGD DGO DGO DGW DOD DOD DOD DOG DOO DOO DOO DOW DWD DWO DWO
Rock Whitebeam: RCK ROC ROK WAM WBA WBE WBM WEA WEA WEB WEE WEM WEM WHA WHB WHE WHE WHI WHM WHT WIA WIB WIE WIE WIM WIT WTA WTB WTE WTE WTM
Sea-buckthorn: BCH BCK BCN BCO BCR BCT BHN BHO BHR BKH BKN BKO BKR BKT BON BOR BRN BTH BTN BTO BTR BUC BUH BUK BUN BUO BUR BUT SEA
Spindle: SDE SDL SID SIE SIL SIN SLE SND SNE SNL SPD SPE SPI SPL SPN
Sallow: SAL SAL SAO SAW SLL SLO SLO SLW SLW SOW
Grey Willow: GEY GRE GRY WIL WIL WIO WIW WLL WLO WLO WLW WLW WOW
Purple Willow: PLE PPE PPL PRE PRL PRP PUE PUL PUP PUR WIL WIL WIO WIW WLL WLO WLO WLW WLW WOW
Common Osier: CMM CMN CMN CMO CMO COM COM CON CON COO OER OIE OIR OSE OSI OSR
Eared Willow: EAD EAE EAR EED ERD ERE WIL WIL WIO WIW WLL WLO WLO WLW WLW WOW
Guelder Rose: GDE GDR GED GEE GEL GER GER GLD GLE GLR GUD GUE GUE GUL GUR ROE ROS RSE
Wayfaring tree: TEE TRE TRE WAA WAF WAG WAG WAI WAI WAN WAN WAR WAR WAY WFA WFG WFI WFN WFR WIG WIN WNG WRG WRI WRN WYA WYF WYG WYI WYN WYR
Common Privet: CMM CMN CMN CMO CMO COM COM CON CON COO PET PIE PIT PIV PRE PRI PRT PRV PVE PVT
Plot's Elm: ELM PLO PLS PLT POS POT PTS
